# Title
Map 1

# Map Grid (terrain symbols in terrain.txt)
#1234567890123456789
MMMMMMMMMMMMMMMMMMMM
MGGGGGGGGGGGGGGGGGGM
MGGGGGGGGGGGGGGGGGGM
MGGGGGGGGGGGGGGGGGGM
MGGGGGGGGGGGGGGGGGGM
MGGGGGGGGGGGGGGGGGGM
MGGGGGGGGGGGGGGGGGGM
MGGGGMMMMMMGGGGGGGGM
MGGGGGGGGGGGGGGGGGGM
MGGMMGGGGGMGGGGGGGGM
MGGGMGGGGGGGGGGGGGGM
MGGGGGGGGMMMMMGGGGGM
MGGGGGGGGGGMMGGGGGGM
MGGGGGGGGGGGMGGGGGGM
MGGMMGGGGGGGGGGGGGGM
MGGGGGGGGGGGGGGGGGGM
MGGGGGGGGGGGGGGGGGGM
MGGGGGGGGGGGGGGGGGGM
MGGGGGGGGGGGGGGGGGGM
MMMMMMMMMMMMMMMMMMMM

# Player 1 Start x, y
9, 16

# Player 2 Start x, y
9, 3